Ы : Ш
  : Ы
М :  
Х : Н
Ф : М
И : Ф
> : И
Р : З
Д : Р
C : Д
Е : Ы
О : Е
Л : Я
У : Л
Т : У
П : Ж
2 : П
1 : О
Ь : Ц
А : Ь
A : В
4 : А
B : Г
R : Т
Ц : Щ
Ч : Ц
< : Ч
Ю : К
К : Ю
8 : К
Б : Э
Й : Х
7 : Й
T : У
5 : Б
